000000000000000
0B-1----------0
0-0-0-0-0-0-0-0
01------------0
0-0-0-0-0-0-0-0
0-------------0
0-0-0-0-0-0-0-0
0-------------0
0-0-0-0-0-0-0-0
0-------------0
0-0-0-0-0-0-0-0
0-------------0
0-0-0-0-0-0-0-0
0-------------0
000000000000000