000000000000000
0------B------0
0-00000-00000-0
0--0000-0000--0
0-0---------0-0
0---000-000---0
0-0---------0-0
0-00-00000-00-0
0-0---------0-0
0---000-000---0
0-0---------0-0
0--0000-0000--0
0-00000-00000-0
0-------------0
000000000000000