000000000000000
0------0------0
0-0--0---0--0-0
0--0--0-0--0--0
0---0-0-0-0---0
0--0-------0--0
0000-00-00-0000
0----00B00----0
0000-00-00-0000
0--0-------0--0
0---0-0-0-0---0
0--0--0-0--0--0
0-0--0---0--0-0
0------0------0
000000000000000