111111111111111
14-0----------1
1-1-1-1-1-1-1-1
100000--------1
1-1-1-1-1-1-1-1
100000000----01
1-1-1-1-101-1-1
1-------0----01
1-1-1-1-101-1-1
1-------------1
1-1-1-1-1-1-1-1
1-------------1
1-1-1-1-1-1-1-1
1-------------1
111111111111111