111111111111111
14------------1
1-1-1-1-1-1-1-1
1-------------1
1-1-1-1-1-1-1-1
1-------------1
1-1-1-1-1-1-1-1
1-------------1
1-1-1-1-1-1-1-1
1-------------1
1-1-1-1-1-1-1-1
1-------------1
1-1-1-1-1-1-1-1
1-------------1
111111111111111