111111111111111
12------------1
1-------------1
1-------------1
1-------------1
1-------------1
1-------------1
1-------4-----1
1--3----------1
1-------------1
1-------------1
1-------------1
1-------------1
1-------------1
111111111111111