000000000000000
04-1----------0
0-0-0-0-0-0-0-0
011111--------0
0-0-0-0-0-0-0-0
011111111----10
0-0-0-0-010-0-0
0-------1----10
0-0-0-0-010-0-0
0-------------0
0-0-0-0-0-0-0-0
0----2--------0
0-0-0-0-0-0-0-0
0-------------0
000000000000000